111111111111111
1P00000000000C1
101111111111101
1C00000000000E1
111111111111111