111111
1P0C01
10E001
1C1011
111111