111111111111111111111111111111
1P0000000000010000000000000001
101111111110101111111111111101
100000000010001000000000000001
101111101011111011111101111101
10000010100000100000K100000001
111101101111101111101111101101
1C00000100000100000010000000C1
101111111111101111111111111101
100000000000001000000000000001
111111101111111011111111101111
1C00010100000100000010000000E1
101110101011101111101011111101
100010001000001000001000000001
111011111111101111111111101111
1C00000000000100000000000000C1
101111111101111111101111111101
100000000001000000000001000001
111111111111111111111111111111