111111111
1P0000001
101011101
100010001
101110101
1C0000E11
111111111