111111111
1P00000C1
101111101
1C0000011
101110101
10000E001
111111111