111111111111
1P0000000001
101111111101
1C00000000E1
111111111111